11111111111
11000111001
10000000001
100N0011111
1000001
1100011
1111111
