1111111
1100011
100W001
100N001
100S001
1100011
1111111