1111111
1100011
1000001
1000001
100E001
1000001
1000001
1100011
1111111